wwwwwwwwwwwwwwwwwwwwwwww
w p                    w
w   wwwwww wwwwww   w  w
w                   w  w
w                   w  w
w                   w  w
w                      w
w                      w
w             wwww     w
w                      w
w                      w
w                      w
w                      w
w                      w
w                      w
w                      w
w                      w
w                      w
w                    t w
wwwwwwwwwwwwwwwwwwwwwwww
