wwwwwwwwwwwwwwwwwwwwwwwww
w                       w
w w wwwwwwwwwwwwwww   w w
w w       c             w
w wwwww wwwwwwwwwwwww w w
w  p  w             w w w
w w wwwww wwwwwwwww w  ww
w w        w         w  w
w wwwwwwwww w wwwwwww   w
w           w    e    w w
w wwwwwwwww wwwwwwww w ww 
w           w          ww
wwwwwwwwwwwwwwwwwww ww  w
w                    w  w 
w wwwwwwwwwwwwwwwww wwwww
w         e            ww 
w wwww wwwwwwwwwwww wwwww
w    w  w         w  w ww
w                tw w   w
wwwwwwwwwwwwwwwwwwwwwwwww